╔═══════════════════════════╗
║..A..........o.........@...║
║.╔═══════╗.═╦═╦═.╔═══════╗.║
║.╚═══════╣..║ ║..╠═══════╝.║
║..@......║..║ ║..║.........║
║.═══════.║..║ ║..║.═══════.║
║A..........═╩═╩═..........A║
║..╔═════╗.......@╔══════╗..║
╚══╚═════╝════════╚══════╝══╝