..............................................
..####.#..#.####.####.####..####..............
..#....#..#.#..#.#..#.##....#.................
..#....####.#..#.#..#...#...####..............
..#....#..#.#..#.#..#....##.#.................
..####.#..#.####.####.#####.####..............
..............................................
..#....####.#.....#.####.#....................
..#....#....#.....#.#....#....................
..#....####..#...#..####.#....................
..#....#......#.#...#....#....................
..####.####....#....####.####.................
..............................................
Enter 1, 2 or 3: 