#############
#.....#..A..#
#@###.#.###.#
#.....o.....#
#.###.#.###.#
#A....#....@#
#############