╔═════╦═════════╗
║.....║..A....@.║
║@═══.║.═══.═══.║
║.....o.........║
║.═══.║.═══.═══.║
║A....║.......@.║
╚═════╩═════════╝