#################
#.....#.......@.#
#@###.#.###.###.#
#.....o.........#
#.###.#.###.###.#
#.....#.......@.#
#################