#################
#     #  A      #
# ### # ### ### #
#               #
# ### # ### ### #
#A    #         #
#################