#################
#.....#..A....@.#
#@###.#.###.###.#
#.....o.........#
#.###.#.###.###.#
#A....#.......@.#
#################