#############################
#..A..........o.........@...#
#.#########.#####.#########.#
#.#########..###..#########.#
#..@......#..###..#.........#
#.#######.#..###..#.#######.#
#A..........#####..........A#
#..#######.......@########..#
#############################