###########################
#............#...........@#
#.####.#####.#.#####.####.#
#.####.#####.#.#####.####.#
#............o............#
#.####.##.#######.##.####.#
#.####.##....#....##.####.#
 ......#           #...... 
#.####....### ###....####.#
#.#######.# AAA #.#######.#
#.#######.#######.#######.#
#@........................#
###########################