######################################
#..A.........................@.......#
#.##################################A#
#.....#........................#.....#
#####.#.##########.###########.#.#####
#.....#@##########.###########.#.....#
..................o...................
#.....##..##################@.##.....#
#####.##......................##.#####
#.....##########################..A..#
#.A...................@..............#
######################################