###########################
#............#...........@#
#.####.#####.#.#####.####.#
#.####.#####.#.#####.####.#
#.####.#####.#.#####.####.#
#............#............#
#.####.##.#######.##.####.#
#.####.##.#######.##.####.#
#......##....#....##......#
######.##
     #.##
     #.##
     #.##
######.##
      .
######.



#............o............#
#.####.##.#######.##.####.#
#.####.##....#....##.####.#
 ......#           #...... 
#.####....### ###....####.#
#.#######.# AAA #.#######.#
#.#######.#######.#######.#
#@........................#
###########################